..........
..........
..........
P..P..P...
....WW....
....WW....
..PP..P...
..PP......
..P.......
..P.......
9 5
2 6
9 6
