..........
..........
..........
...P..P...
....WW....
....WW....
PPPP..P...
..PP......
..P.......
..P.......
9 5
2 6
1 6
